93 57 31 999 68 41 94 82 46 87 83 23 13 8 73 71 10 999 98 43 6 69 44 999 99 44 45 65 69 999 37 999 55 999 28 32 4 51 5 999 30 93 31 94 85 24 97 19 80 49 41
98 999 999 999 24 999 999 999 1 999 999 999 46 999 999 999 999 999 15 999 999 999 999 999 43 999 60 999 999 999 50 999 52 999 999 999 999 999 53 999 999 999 89 999 999 999 999 999 999 999 999
73 29 12 54 85 78 80 999 89 63 4 999 3 94 28 96 59 999 35 29 18 37 55 999 37 999 26 94 79 42 96 999 65 80 77 34 79 74 77 30 20 18 20 95 39 46 40 43 1 21 82
999 999 90 999 95 999 33 999 28 999 999 999 56 999 999 999 44 999 21 999 999 999 999 999 64 999 999 999 999 999 52 999 52 999 57 999 999 999 24 999 92 999 999 999 69 999 999 999 90 999 999
98 29 70 999 37 999 66 999 1 999 75 17 85 61 84 999 2 40 88 23 10 19 8 42 1 54 65 32 4 999 12 89 80 13 55 999 72 999 36 29 44 999 74 999 19 68 93 999 77 34 99
22 999 99 999 999 999 999 999 999 999 999 999 999 999 999 999 30 999 999 999 22 999 999 999 19 999 96 999 52 999 999 999 77 999 79 999 78 999 999 999 999 999 15 999 999 999 999 999 999 999 999
58 999 70 24 64 27 90 24 64 31 43 87 82 58 70 27 29 43 62 999 6 999 89 14 28 999 64 999 92 41 14 999 12 999 81 45 48 999 18 999 90 34 37 999 34 999 99 87 2 999 72
60 999 999 999 44 999 999 999 66 999 999 999 999 92 999 999 72 999 999 999 3 999 999 999 999 999 999 999 9 999 999 999 999 999 52 999 59 999 93 999 999 999 51 999 39 999 22 999 41 999 67
40 54 76 999 72 63 16 999 98 39 61 999 60 97 6 94 19 26 76 999 75 43 81 16 64 88 58 999 47 37 97 59 93 999 22 16 21 27 64 81 50 86 75 92 94 57 82 20 83 18 90
25 999 74 999 999 999 999 999 44 999 96 999 999 999 33 999 999 999 22 999 999 999 999 999 999 49 20 999 999 999 999 999 999 67 55 999 999 999 28 999 78 999 21 999 999 999 999 999 999 999 36
80 999 18 26 22 71 67 999 99 999 55 52 40 999 31 69 42 999 6 999 5 37 76 36 5 2 41 53 77 4 89 50 63 999 3 999 77 68 90 999 94 999 15 999 98 97 16 86 92 999 88
999 999 60 999 999 999 999 999 999 999 999 999 999 999 31 999 57 999 95 999 63 999 98 999 46 999 999 999 7 999 83 999 88 999 999 999 999 999 70 999 26 999 61 999 13 999 999 999 999 999 999
54 999 83 25 89 93 44 40 1 20 15 54 96 999 33 999 86 999 9 45 61 999 10 999 70 14 14 999 94 999 86 999 23 4 98 6 93 999 1 999 32 999 38 32 91 35 97 64 80 73 7
62 999 53 999 999 999 49 999 25 999 999 999 95 999 999 999 52 999 84 999 63 999 999 999 58 999 999 999 83 999 999 999 999 999 999 999 97 999 34 999 999 999 999 999 999 999 999 999 16 999 999
15 67 79 99 8 999 44 999 25 58 4 999 84 999 73 2 25 999 51 999 3 17 95 999 73 999 94 999 95 999 56 999 94 999 7 999 32 999 59 90 9 1 83 94 64 33 68 999 42 99 55
11 999 61 999 999 999 95 999 44 999 16 999 999 999 13 999 999 999 3 999 999 999 3 999 999 999 39 999 999 999 14 999 62 999 32 999 999 999 999 999 999 999 999 999 95 999 999 999 999 999 22
37 999 80 22 48 999 48 63 55 999 67 42 16 999 66 999 67 13 42 999 68 999 84 58 12 79 5 27 4 10 47 58 74 96 77 41 30 2 4 999 83 12 16 999 17 30 68 999 85 999 25
32 999 999 999 999 999 39 999 35 999 46 999 18 999 999 999 27 999 75 999 30 999 73 999 999 999 999 999 29 2 999 999 64 999 67 999 87 999 3 999 37 999 999 999 64 999 999 999 34 999 999
74 75 42 25 43 999 10 999 43 999 99 999 53 999 62 62 62 999 88 999 23 62 82 91 18 999 99 999 94 32 44 999 48 999 40 999 47 999 55 28 51 9 52 18 66 60 70 29 4 76 6
7 999 999 999 53 999 33 999 98 999 94 999 30 999 999 999 999 999 60 999 999 999 3 999 29 999 75 999 999 999 999 999 82 999 999 999 78 999 74 999 999 999 90 999 999 999 36 999 69 999 999
76 78 32 999 29 999 81 999 99 999 82 999 68 999 77 5 65 38 76 999 61 56 96 999 37 32 77 3 28 999 36 999 31 44 46 999 30 999 5 25 33 87 78 96 82 999 36 999 81 6 42
47 999 31 999 999 999 70 999 999 999 53 999 999 999 999 999 999 999 999 999 999 49 999 999 62 999 999 999 64 999 38 999 69 999 999 999 999 999 32 999 999 999 999 999 95 999 87 999 999 999 24
67 99 11 24 6 999 97 999 21 18 42 44 97 51 3 19 59 999 92 12 83 48 57 96 36 50 92 999 89 999 82 999 47 92 60 30 42 999 37 57 52 31 6 39 75 999 56 999 36 999 48
1 999 5 999 9 999 1 999 53 999 999 999 999 999 999 999 999 999 999 999 999 999 999 999 6 999 999 999 72 999 33 999 79 999 999 999 72 999 999 999 999 999 999 999 999 999 999 999 56 999 67
4 999 7 999 43 999 19 999 79 75 72 73 85 12 99 71 50 18 75 16 3 64 22 999 87 21 11 999 79 33 58 999 31 999 67 42 60 15 89 80 11 999 51 999 1 999 25 68 12 999 78
999 999 17 999 999 999 39 999 999 999 999 999 999 999 5 999 70 999 83 999 33 999 999 999 45 999 28 999 999 999 999 999 999 999 999 999 999 999 999 999 999 999 20 999 27 999 63 999 999 999 72
20 21 79 40 18 999 3 18 58 999 95 29 40 38 10 68 81 999 70 999 44 999 64 30 83 73 20 45 17 999 8 19 41 44 11 999 77 999 37 999 91 4 80 56 15 999 19 92 37 999 31
999 999 98 999 67 999 999 999 49 999 76 999 15 999 21 999 31 999 999 999 999 999 99 999 94 999 999 999 6 999 99 999 999 999 999 999 19 999 14 999 999 999 41 999 999 999 82 999 999 999 999
52 999 38 999 54 999 67 999 74 999 63 999 57 999 67 999 35 999 81 64 18 21 73 999 89 999 2 12 73 44 60 71 88 7 92 41 84 39 45 33 74 96 65 11 71 54 51 39 26 999 20
41 999 94 999 999 999 95 999 999 999 999 999 78 999 999 999 999 999 999 999 999 999 999 999 30 999 19 15 3 999 999 20 999 999 999 999 999 999 999 999 999 999 999 999 999 999 62 999 42 999 90
40 999 67 78 62 999 48 94 46 23 64 34 23 90 62 12 26 999 76 51 26 81 93 97 81 999 56 999 5 50 46 59 17 12 19 6 53 999 15 999 92 44 49 49 55 999 80 999 50 999 7
37 999 42 999 25 999 49 999 999 999 999 999 999 999 999 999 48 999 999 999 37 999 57 999 7 999 999 999 65 999 75 999 81 999 999 999 49 999 3 999 57 999 999 999 999 999 999 92 999 999 13
34 66 23 999 72 999 2 7 13 999 7 999 75 999 94 999 70 62 45 999 30 999 24 999 81 999 9 88 24 999 44 999 62 999 74 999 67 98 21 14 88 40 22 73 1 97 85 23 61 24 89
72 999 95 999 6 56 31 999 999 999 87 999 49 999 39 999 999 999 87 999 999 999 8 999 88 999 999 999 93 999 999 999 99 999 54 999 64 999 96 999 999 41 999 999 999 999 95 999 45 999 98
19 999 50 999 5 92 40 999 68 18 27 72 21 26 7 96 43 999 77 999 86 26 37 999 14 999 46 94 38 999 2 72 36 29 25 999 52 999 26 85 32 66 60 24 92 999 54 999 90 999 32
78 999 32 999 27 999 999 999 72 999 999 999 999 999 72 999 999 999 999 999 24 999 41 999 999 999 999 999 84 999 999 999 31 999 35 999 999 999 79 999 999 999 999 999 999 999 25 999 71 999 78
16 999 55 999 3 72 25 37 50 54 15 8 94 999 90 70 69 999 62 52 96 999 30 999 63 5 96 37 4 23 7 999 65 999 37 999 76 999 21 44 16 66 85 45 22 999 51 999 89 999 55
999 999 28 999 22 999 999 999 64 999 24 999 999 999 999 999 999 999 999 3 51 999 18 999 999 999 999 999 54 999 999 999 999 999 58 999 98 999 999 999 999 999 68 999 999 999 999 999 51 999 999
84 48 62 999 47 61 35 999 26 999 59 83 34 72 46 34 67 999 67 60 96 97 51 95 61 25 83 999 11 91 47 32 12 999 11 999 51 76 63 54 16 999 26 30 94 71 99 999 42 58 96
999 999 999 999 73 999 999 999 999 999 999 999 999 999 999 999 999 999 27 999 81 999 999 999 999 999 37 999 64 999 999 999 999 999 999 999 32 999 999 999 999 999 15 999 999 999 999 999 999 999 999
23 48 82 32 10 28 22 16 42 26 31 68 38 70 45 10 44 21 25 999 28 45 48 999 5 88 63 5 11 999 42 15 76 49 19 32 11 17 64 91 15 999 91 999 11 999 25 999 64 95 46
999 999 999 999 29 67 999 999 999 999 999 999 39 999 999 999 5 999 74 999 999 999 999 999 999 999 999 999 29 999 42 999 999 999 999 999 55 999 999 999 33 999 999 999 20 999 83 999 37 999 999
64 80 1 87 41 5 42 96 93 52 87 65 20 81 64 999 62 999 20 999 70 999 75 55 12 2 12 92 55 28 39 58 98 25 58 999 63 6 77 999 62 46 42 54 63 47 97 99 42 87 37
8 999 999 999 11 40 999 999 999 999 999 999 78 999 57 999 999 999 999 999 44 999 9 999 999 999 74 999 81 999 7 999 57 51 999 999 82 999 999 999 999 999 999 999 42 999 23 999 999 999 999
43 999 9 34 42 17 30 76 56 999 67 86 1 999 64 23 48 72 92 999 33 72 33 999 48 55 6 999 59 999 56 999 44 13 24 999 98 52 26 999 16 999 29 70 18 999 38 16 85 65 75
4 999 39 999 75 999 79 999 999 999 98 999 29 999 999 999 88 999 77 999 18 999 57 999 999 999 30 999 999 999 75 999 999 72 14 999 57 999 999 999 2 999 999 999 999 999 98 999 90 999 999
53 999 18 999 68 999 65 49 70 999 7 999 34 70 11 999 2 999 92 999 84 999 91 999 92 10 32 999 98 72 73 999 73 14 39 999 92 80 85 8 49 40 40 62 25 999 43 999 8 86 13
3 999 89 999 3 999 999 999 82 999 76 999 999 999 999 999 999 999 999 999 75 999 999 999 999 999 73 999 999 999 999 999 93 999 999 999 13 999 999 999 82 999 9 999 999 999 999 999 19 999 64
43 999 5 999 76 15 22 999 95 999 37 23 97 999 39 999 93 67 13 40 3 999 60 22 45 26 46 84 69 33 2 999 16 90 38 999 20 29 81 75 8 79 6 10 23 999 30 49 99 999 82
15 999 999 25 79 999 75 999 999 999 999 999 999 999 78 999 999 42 93 999 999 999 87 999 5 999 22 999 999 999 999 999 999 999 60 999 999 999 15 999 999 999 999 999 999 999 68 999 999 999 999
17 999 4 13 41 999 55 84 54 43 92 2 30 14 99 67 79 999 7 68 49 999 89 999 56 999 56 84 18 5 95 90 58 999 86 95 59 999 51 26 36 8 85 47 14 999 36 30 81 73 89
