84 999 6 999 56 999 28 57 45 999 40 54 3 999 2 19 7 25 78 35 61 999 69 42 60 34 41 74 74 16 96 11 9 61 91 999 17 999 16 2 63 999 8 999 83 85 2 999 85 999 15
25 999 86 999 73 999 52 999 999 999 999 999 73 999 999 999 999 999 63 999 44 999 999 999 999 999 51 999 999 999 999 999 999 999 999 999 10 999 3 999 999 999 68 999 30 999 999 999 72 999 92
23 55 37 50 59 10 57 999 88 28 27 999 93 999 48 999 32 33 15 999 72 999 20 43 64 999 89 999 1 2 25 42 7 9 77 999 47 56 14 90 9 89 96 53 8 99 8 999 75 75 27
999 999 7 999 34 999 999 999 999 999 93 999 88 999 49 999 67 999 999 999 39 999 14 999 999 999 7 999 999 999 999 999 26 999 999 999 999 999 9 999 999 999 71 999 999 999 999 999 18 999 999
70 999 24 999 71 25 73 60 68 31 16 85 49 32 76 38 10 79 34 34 66 999 46 53 76 26 31 54 44 85 10 30 48 21 73 999 36 88 96 44 46 999 41 24 54 9 83 76 83 96 84
25 999 999 999 999 999 999 999 999 999 999 999 999 999 999 999 2 999 999 999 999 999 34 999 999 999 999 999 999 999 999 999 999 999 999 999 999 999 96 999 999 999 999 999 999 999 999 999 999 999 999
80 38 54 999 5 76 88 43 25 11 98 999 70 71 72 80 38 999 16 50 97 13 17 999 34 60 41 999 81 999 86 999 31 76 48 999 41 14 61 999 99 8 13 17 88 41 75 999 11 999 58
999 999 36 999 999 999 999 999 999 999 91 999 51 999 999 999 31 999 36 999 999 999 999 999 8 999 999 999 43 999 4 999 999 999 72 999 999 999 43 999 68 999 999 999 999 999 999 999 43 999 21
11 56 51 999 48 999 50 19 36 64 39 36 6 999 72 999 39 999 67 73 25 999 99 999 86 83 90 999 13 81 54 37 14 999 20 999 74 999 80 17 59 26 45 999 48 999 64 999 44 999 32
999 999 99 999 86 999 999 999 19 999 999 999 999 999 14 999 88 999 47 999 999 999 36 999 67 999 999 999 94 999 999 999 999 999 75 999 92 999 50 999 999 999 999 999 78 999 94 999 47 999 86
65 36 38 999 92 61 95 999 36 999 69 4 86 999 65 92 81 97 4 72 8 999 90 73 48 53 92 999 2 999 54 28 99 83 81 29 40 89 85 999 77 999 19 79 26 45 55 999 26 16 69
12 999 31 999 999 999 87 999 999 999 999 999 80 999 999 999 999 999 999 999 80 999 14 999 27 999 999 999 93 999 999 999 6 999 999 999 8 999 999 999 74 999 76 999 999 999 999 999 52 999 29
50 999 64 61 53 65 59 10 95 60 74 8 54 30 19 63 14 999 38 999 5 54 16 999 44 999 45 53 70 19 91 55 88 63 32 999 62 90 15 57 42 32 94 999 63 17 73 999 58 999 87
30 999 80 999 41 999 74 999 999 999 21 999 18 999 999 999 76 999 19 999 48 999 69 999 999 999 14 999 999 999 74 999 57 999 999 999 61 999 79 999 92 999 999 999 20 999 999 999 69 999 999
7 999 37 999 73 999 93 999 59 10 75 999 14 999 2 16 89 88 75 86 22 999 24 95 29 999 70 5 48 999 95 999 70 8 18 999 62 999 30 999 61 75 64 22 65 999 88 22 11 999 59
87 999 80 999 999 999 99 999 90 999 999 999 999 999 70 999 999 999 5 999 52 999 5 999 999 999 65 999 999 999 999 999 999 999 999 999 999 999 12 999 999 999 999 999 999 999 78 999 999 999 45
22 999 59 999 99 48 55 999 16 999 84 25 97 999 99 88 52 999 90 999 99 999 52 73 32 80 41 77 52 36 52 41 9 36 87 55 14 999 83 999 50 73 67 999 8 16 13 56 73 65 42
999 999 94 999 999 999 85 999 24 999 999 999 16 999 65 999 9 999 999 999 78 999 51 999 12 999 49 999 58 999 26 999 999 999 95 999 31 999 999 999 31 999 999 999 5 999 999 999 999 999 999
44 87 44 999 44 59 93 999 79 999 46 15 54 16 46 999 11 999 72 39 32 999 31 999 55 999 93 999 29 999 76 999 68 66 22 999 70 17 15 99 91 999 77 20 78 55 77 69 69 93 19
77 999 999 999 16 999 999 999 999 999 18 999 96 999 79 999 22 999 25 999 65 999 999 999 78 999 83 999 999 999 999 999 32 999 999 999 999 999 7 999 999 999 67 999 999 999 76 999 999 999 999
49 999 24 12 26 44 96 999 32 99 47 999 5 999 38 999 76 999 44 999 4 999 37 73 96 999 72 27 34 14 41 62 21 95 73 91 69 999 5 34 28 88 15 68 94 999 46 999 50 999 3
10 999 79 999 56 999 999 999 999 999 999 999 999 999 95 999 58 999 999 999 92 999 999 999 999 999 96 999 999 999 5 999 28 999 999 999 999 999 999 999 999 999 14 999 999 999 999 999 36 999 11
63 999 30 999 28 999 52 65 46 38 72 999 32 43 68 999 39 999 95 49 12 999 25 33 81 999 32 999 40 42 71 999 40 84 90 23 83 71 49 70 22 999 61 999 15 32 4 999 64 84 94
999 999 76 999 62 999 999 999 999 999 2 999 15 999 3 999 29 999 10 999 32 999 12 999 999 999 999 999 999 999 999 999 55 999 999 999 28 999 999 999 11 999 67 999 4 999 999 999 83 999 999
33 80 68 999 48 999 8 16 86 92 31 92 63 999 21 999 14 999 56 999 72 34 27 999 7 84 74 31 3 94 93 90 92 16 73 30 21 999 76 999 97 999 62 59 55 79 66 30 3 15 57
33 999 999 999 4 999 67 999 999 999 13 999 999 999 999 999 18 999 9 999 78 999 87 999 999 999 999 999 999 999 5 999 999 999 57 999 999 999 46 999 86 999 8 999 58 999 999 999 999 999 35
94 999 10 72 83 999 40 999 67 73 9 999 74 97 85 21 6 999 53 999 69 999 68 66 18 48 3 999 17 93 39 999 51 8 29 54 55 54 77 999 74 999 10 999 19 8 63 27 25 999 77
999 999 84 999 20 999 999 999 80 999 999 999 999 999 999 999 23 999 25 999 999 999 999 999 999 999 999 999 999 999 48 999 14 999 13 999 999 999 63 999 999 999 999 999 41 999 73 999 999 999 89
37 16 27 999 25 999 75 8 7 999 44 86 57 72 5 33 10 999 57 46 98 76 58 41 47 25 27 999 59 22 53 999 40 999 47 999 35 26 45 27 97 31 35 999 39 999 99 98 11 999 66
83 999 81 999 999 999 999 999 999 999 999 999 999 999 999 999 57 999 999 999 63 999 999 999 999 999 999 999 33 999 999 999 37 999 80 999 95 999 27 999 70 999 999 999 23 999 59 999 2 999 999
66 999 35 62 93 999 55 23 38 999 10 90 30 999 52 999 53 999 69 97 66 91 82 52 93 26 38 999 54 999 55 44 59 999 97 999 86 999 2 999 27 32 5 999 34 999 7 999 20 64 29
58 999 1 999 999 999 24 999 67 999 1 999 40 999 77 999 88 999 76 999 98 999 88 999 999 999 999 999 999 999 999 999 60 999 999 999 999 999 15 999 92 999 36 999 999 999 95 999 999 999 97
69 999 77 45 83 999 93 999 2 83 82 75 27 44 43 36 11 999 12 999 22 999 82 22 48 999 43 55 88 999 51 45 21 999 78 51 10 74 42 999 18 999 6 8 91 999 61 86 46 999 71
999 999 72 999 999 999 40 999 70 999 67 999 72 999 1 999 54 999 999 999 3 999 999 999 36 999 3 999 999 999 999 999 999 999 22 999 76 999 68 999 92 999 999 999 7 999 999 999 999 999 5
92 52 54 30 7 999 38 999 51 999 21 999 25 999 41 999 9 999 58 92 55 54 56 999 61 999 7 92 3 28 14 999 5 4 24 999 92 999 73 999 97 16 91 999 40 999 38 50 24 48 64
40 999 21 999 999 999 999 999 999 999 55 999 999 999 96 999 999 999 1 999 999 999 999 999 999 999 94 999 84 999 999 999 999 999 13 999 58 999 81 999 19 999 999 999 999 999 999 999 1 999 88
65 999 65 78 23 999 90 87 73 62 34 78 7 999 63 999 24 11 27 93 16 52 91 44 43 96 62 999 55 57 45 6 41 999 9 999 1 999 94 999 31 95 98 25 25 999 14 33 37 999 10
999 999 65 999 6 999 77 999 41 999 96 999 999 999 95 999 999 999 999 999 90 999 999 999 87 999 999 999 52 999 14 999 97 999 999 999 90 999 999 999 58 999 999 999 23 999 999 999 24 999 56
5 48 70 999 81 999 99 999 7 999 88 999 45 18 13 999 36 9 40 45 88 90 90 999 67 31 57 999 86 999 45 999 97 75 19 999 63 999 61 98 46 999 44 31 81 99 60 999 40 999 55
10 999 999 999 999 999 999 999 999 999 47 999 61 999 18 999 999 999 30 999 51 999 999 999 57 999 999 999 999 999 7 999 25 999 999 999 80 999 14 999 64 999 93 999 18 999 999 999 29 999 999
13 93 40 84 4 999 71 32 3 77 5 999 57 999 3 999 3 9 97 999 85 29 86 999 39 89 32 999 38 999 40 999 53 999 48 59 59 999 54 999 34 999 64 999 79 999 79 40 7 999 79
14 999 41 999 71 999 999 999 30 999 999 999 35 999 999 999 96 999 60 999 999 999 7 999 999 999 999 999 24 999 999 999 999 999 999 999 999 999 92 999 21 999 999 999 30 999 999 999 56 999 9
62 999 34 999 66 999 40 60 11 999 63 40 4 999 14 39 22 999 2 999 17 68 2 79 18 8 89 29 52 999 66 999 85 24 8 999 92 999 58 999 20 69 57 999 50 999 70 86 82 999 14
47 999 999 999 999 999 999 999 999 999 22 999 88 999 21 999 999 999 999 999 29 999 65 999 7 999 49 999 999 999 86 999 79 999 999 999 29 999 999 999 999 999 64 999 999 999 999 999 44 999 20
51 999 14 93 32 999 41 999 64 84 10 999 12 999 74 58 14 45 67 999 34 999 99 999 73 999 11 77 96 38 4 24 7 999 77 6 52 50 58 65 88 999 88 66 69 999 18 999 96 29 9
22 999 999 999 8 999 40 999 999 999 61 999 999 999 81 999 999 999 999 999 999 999 80 999 999 999 20 999 999 999 999 999 999 999 999 999 89 999 63 999 999 999 62 999 9 999 82 999 999 999 52
61 999 9 28 33 65 47 59 63 999 50 999 4 75 79 85 97 84 38 999 23 41 93 999 32 92 35 15 25 39 15 74 66 34 19 26 20 999 22 999 24 999 22 999 4 79 22 999 79 64 62
84 999 999 999 52 999 999 999 16 999 89 999 10 34 61 999 999 999 999 999 44 999 68 999 999 999 86 999 999 999 70 999 3 999 999 999 31 999 74 999 17 999 999 999 95 999 999 999 98 999 999
86 999 38 18 74 999 89 999 49 8 63 999 36 999 59 67 84 2 82 999 70 999 93 999 65 66 29 84 90 999 95 999 82 7 77 999 81 999 61 79 45 93 8 999 73 62 83 999 22 999 7
84 999 999 999 999 999 4 999 71 999 77 999 999 999 93 999 999 999 2 999 5 999 999 999 999 999 999 999 70 999 999 999 16 999 999 999 999 999 41 999 999 999 999 999 49 999 97 999 91 999 57
32 999 61 68 41 2 47 6 14 999 46 56 95 999 3 999 53 67 12 999 73 76 1 30 12 999 35 22 99 77 91 999 71 11 19 87 6 999 73 12 15 19 23 999 5 999 29 999 33 46 44
